NO ./map.cub
SO ./map.cub
WE ./map.cub
EA ./map.cub

F 255,100,0
C 225,30,0

111111111
100000001
100000001
100000001
101000001
100100001
10N000001
111111111