NO ./textures/blackhole/blackhole_north.xpm
SO ./textures/blackhole/blackhole_south.xpm
WE ./textures/blackhole/blackhole_west.xpm
EA ./textures/blackhole/blackhole_east.xpm
C 10, 10, 10
F 10, 10, 10

11111111111111N
100000000000001
100000000000001
100000000000001
100000000000001
100000000000001
100000000000001
100000000000001
111111111111111