NO ./textures/blackhole/blackhole_north.xpm
SO ./textures/blackhole/blackhole_south.xpm
WE ./textures/blackhole/blackhole_west.xpm
EA ./textures/blackhole/blackhole_east.xpm
C 10, 10, 10
F 10, 10, 10

1111111111111111111111111
1000000000000000000000001
1000000000000000000000001
1000000000000000000000001
1000000111111111110000001
10000001         10000001
10000001         10000001
10000001         10000001
10000001         10000001
10000001         10000001
10000001         10000001
1000000111110111110000001
1000000000000000000000001
100000000000N000000000001
1000000000000000000000001
1111111111111111111111111