NO ./textures/blackhole/blackhole_north.xpm
SO ./textures/blackhole/blackhole_south.xpm
WE ./textures/blackhole/blackhole_west.xpm
EA ./textures/blackhole/blackhole_east.xpm

F 220, 100, 0
C 225, 30, 0

111111
100101
101001
1100N1
111111