NO ./textures/blackhole/blackhole_north.xpm
SO ./textures/blackhole/blackhole_south.xpm
EA ./textures/blackhole/blackhole_east.xpm
C 225,30,0
F 10,30,0

111111111111111
100000000000001
111111100010001
100010000010001
1000100N0010001
100000000010001
100111111111111
100000000000001
111111111111111
WE ./textures/blackhole/blackhole_west.xpm