NO ./sprites/north.xpm
SO ./sprites/south.xpm
WE ./sprites/west.xpm
EA ./sprites/east.xpm
C 135,206,235
F 211,211,211

                        

                                        111111 
        1111111111111111111111111        111111
        1000000000110000000000001        1111111
        1011000001110000000000001        1111111
        1001000000000000000000001        1111111
111111111011000001110000000000001        1111111
100000000011000001110111111111111        1111111
11110111111111011100000010001
11110111111111011101010010001
11000000110101011100000010001
10010000000000N01100000010001 
1000000000000000110101001001 
11000001110101011111011110101                   11111
11110111 1110101 101111010001                   1111111
11111111 1111111 11111111111                    111111
