SO ./sprites/nature_so.xpm
NO ./sprites/tree_no.xpm
WE ./sprites/tree_we.xpm
EA ./sprites/tree_ea.xpm

F 154,205,50
C 10,214,255

111111111
1000000011111
10000000000001
100000000000001
1010000011111001
1001000010000001
10N0000010000111
1111111110001111
1111100000011101
1100000011000001
1111110000011111
11111111111111